111111111111111111111111111111
100000000000000000000000000001
10000000C000001111111000000001
10000000C000000000000000000001
10011000C000000000000000000001
10000000C011111111111000000001
10000000C000000000000000000001
10000000C0000V0000000000000001
10000000C0000H00000000E0000001
10000000C0000F0000000000000001
10000000C000000000000000000001
10000000C000000000000000000001
10000000C000000000011110000001
100000C0P000000000000000000001
100000000000000000000000000001
111111111111111111111111111111