111111111111
100000000001
000000000001
100000000001
100000C0P001
100000E00001
111111111111