111111111111111111111111111111
100000000000000000000000000001
10000000C000000000000000000001
10000000C000000000000000000001
10000000C000000000000000000001
10000000C000000000000000000001
10000000C000000000000000000001
10000000C000000000000000000001
10000000C0000000000000E0000001
10000000C000000000000000000001
10000000C000000000000000000001
10000000C000000000000000000001
10000000C000000000000000000001
100000C0P000000000000000000001
100000000000000000000000000001
111111111111111111111111111111