111111111
1E0C00001
1P100V001
111C00001
111111111