111111111111111111111111111111111111111111111111111111111111
100000000000000000000000000000000111111111111111111110000111
10P00000000000000000000000C000000111111111111111111110000111
100000000000000000000000000000000111111111111111111110000111
10000C000000000000000000000000000111111111111111111110000111
100000000000000000000000000000000111111111111111111110000111
100000000000000000000000000000000111111111111111111110000111
100000000000000000000000000000000111111111111111111110000111
100000000C00000000000000000000000111111111111111111110000111
100000000000000000000000000000000111111111111111111110000111
100000000000000000000000000000000111111111111111111110000111
100000000000000000000000000000000111111111111111111110000111
1000000000000000000C0000000000000111111111111111111110000111
100000000000000000000000000000000111111111111111111110000111
100000000000000000000000000000000111111111111111111110000111
10000000000000000000000000000C000111111111111111111110000111
100000000000000000000000000000000111111111111111111110000111
1000000C00000000000000000000000E0111111111111111111110000111
100000000000000000000000000000000111111111111111111110000111
100000000000000000000000000000000111111111111111111110000111
100000000000000000000000000000000111111111111111111110000111
100000000000000000000000000000000111111111111111111110000111
100000000000000000000000000000000111111111111111111110000111
111111111111111111111111111111111111111111111111111110000111
111111111111111111111111111111111111111111111111111110000111
111111111111111111111111111111111111111111111111111110000111
111111111111111111111111111111111111111111111111111111111111
111111111111111111111111111111111111111111111111111111111111
111111111111111111111111111111111111111111111111111111111111
111111111111111111111111111111111111111111111111111111111111
111111111111111111111111111111111111111111111111111111111111
111111111111111111111111111111111111111111111111111111111111
111111111111111111111111111111111111111111111111111111111111