111111111
1C0C00C01
11P00CC11
111011111
10CC00E01
111111111